6 26 7
0 0 0 1 1 1
0 0 0 1 1 1
2 3 0 0 1 1
0 3 0 0 1 1
2 2 4 4 0 1
2 4 4 4 0 0
: Top tiles bottom wind values
8 2 0 2 0 0
0 0 0 5 0 0
0 0 8 0 3 0
6 0 0 0 1 0
2 0 0 0 0 9
0 0 0 0 0 0