15 15 5 64
3 3 3 3 3 0 1 1 0 2 0 2 0 2 4
3 3 3 0 0 0 1 1 4 2 0 2 0 2 4
3 3 2 0 3 1 1 1 4 0 0 2 0 2 0
4 4 0 0 3 1 5 0 1 4 4 4 0 2 0
4 0 0 5 3 1 5 0 1 0 0 0 0 0 0
4 0 3 3 3 1 5 0 1 1 0 0 0 5 5
3 0 3 3 1 1 5 0 0 1 0 0 0 5 5
3 0 0 3 1 5 5 0 0 1 1 4 0 5 5
3 2 0 3 1 5 0 4 0 3 1 4 0 0 5
3 3 0 1 1 0 4 4 3 3 1 4 0 0 0
3 1 1 1 0 4 4 4 0 1 1 4 4 4 0
1 1 1 0 4 4 0 0 1 1 1 1 1 1 1
1 1 1 1 1 1 1 1 1 1 4 4 4 0 0
2 2 1 1 1 1 1 1 1 4 4 0 0 0 3
2 2 2 2 2 0 0 0 0 0 0 0 0 3 3
0 0 0 0 8 0 0 0 0 2 0 0 0 0 0
0 0 7 0 0 0 0 0 0 0 0 2 0 0 0
0 0 0 0 2 0 0 0 0 0 0 0 0 0 0
0 0 0 0 0 0 0 0 2 0 0 2 0 0 0
0 0 0 0 0 0 0 0 2 0 0 0 0 0 0
4 3 0 0 0 0 0 0 0 0 9 0 0 0 0
0 0 1 0 0 0 0 5 0 4 0 1 0 0 0
2 0 0 0 0 0 0 0 0 0 0 0 0 7 0
0 0 0 0 0 0 0 0 0 0 0 0 0 0 0
0 0 0 0 4 0 0 0 0 0 0 6 0 0 0
0 0 0 0 0 0 0 0 0 0 0 0 0 0 0
0 0 0 0 0 0 0 0 0 0 0 0 0 2 0
0 0 0 0 0 0 0 0 0 2 0 0 0 0 0
0 0 2 0 0 0 0 0 2 0 0 0 0 0 4
0 0 0 0 0 8 0 0 0 0 0 0 0 4 3