6 6 3 30
3 3 3 3 1 1
0 1 1 1 1 0
1 1 3 0 0 0
3 3 0 0 0 0
3 4 0 0 0 0
4 4 4 2 2 2
3 0 0 0 0 0
0 0 0 0 0 0
0 0 4 2 0 0
0 1 0 4 0 0
0 1 0 0 0 0
0 0 0 0 0 0