10 15 4
0 0 0 0 1 1 1 1 1 1
0 0 1 1 1 1 1 1 1 1
1 1 1 1 1 1 0 0 0 0
1 1 1 1 0 0 0 0 0 0
0 0 2 0 0 0 0 0 0 1
0 2 0 2 0 0 0 0 1 1
0 0 0 0 0 0 0 1 1 1
0 0 0 0 0 0 0 1 1 1
0 0 0 0 0 0 0 1 1 0
0 0 0 0 0 0 1 1 1 0
0 0 0 0 1 1 1 1 1 0
0 0 1 1 1 1 1 1 0 0
1 1 1 1 1 1 0 0 0 0
1 1 1 1 0 0 0 0 0 0
0 0 0 0 0 0 0 0 0 0
0 0 0 0 0 0 0 0 0 0
0 0 0 0 0 0 9 2 9 4
0 0 0 0 4 4 0 0 0 6
2 2 3 2 0 3 6 0 6 0
0 0 0 0 0 0 6 0 0 2
0 0 0 0 0 0 0 0 8 0
0 0 0 0 0 0 0 4 0 0
0 0 0 3 0 0 0 2 0 0
6 6 0 6 6 0 0 2 0 0
0 0 0 0 0 0 8 0 0 0
3 6 0 0 2 8 0 0 0 0
0 0 2 4 0 0 0 0 0 0
2 8 0 0 0 0 0 0 0 0
0 0 0 0 0 0 0 0 0 0
0 0 0 0 0 0 0 0 0 0