6 6 3 15
0 1 2 2 2 4
0 1 0 0 0 4
1 1 0 0 4 4
1 4 0 0 0 4
4 0 0 0 0 0
0 0 0 0 0 0
0 0 0 0 0 0
1 9 0 0 0 1
0 0 0 0 3 0
0 0 0 0 0 0
0 8 0 0 4 0
2 0 0 0 0 0