15 8 1 8
1 1 1 5 4 4 5 5 5 4 0 2 2 2 4
1 1 1 1 1 4 0 0 0 4 4 0 0 0 4
5 4 1 1 1 1 1 0 0 0 4 2 2 4 4
5 0 2 2 1 1 1 1 2 0 4 4 4 0 0
5 0 2 1 1 1 1 1 1 2 0 4 0 0 0
3 0 2 1 1 1 1 1 1 2 0 4 2 2 4
4 4 3 3 1 1 1 1 2 0 4 0 0 0 4
4 3 3 3 3 3 0 0 0 0 4 2 2 4 4
0 0 0 0 0 0 0 0 8 0 5 0 0 0 0
0 0 0 0 0 0 0 0 0 0 0 0 0 0 0
0 6 0 0 0 0 6 0 0 0 0 0 0 5 0
0 0 0 0 0 0 0 0 0 0 0 0 0 0 1
0 0 0 0 0 9 9 0 0 0 0 0 0 4 0
4 0 0 0 0 0 0 0 0 0 0 3 0 0 0
0 0 0 0 0 0 5 0 0 0 0 0 8 0 0
0 0 0 0 0 3 0 0 2 0 0 0 0 0 0