10 10 3 40
3 3 3 3 3 3 0 1 4 2
3 3 3 3 3 4 0 1 0 4
3 3 3 0 0 1 1 1 2 2
4 4 0 1 1 1 2 2 4 0
1 1 1 1 0 4 4 0 2 1
5 4 0 4 4 2 2 0 1 1
5 0 5 4 0 0 4 1 1 1
5 0 5 0 5 5 4 1 1 1
5 4 5 0 4 0 1 1 1 1
4 0 5 4 5 5 1 1 1 1
0 0 0 0 0 0 0 3 0 0
0 0 0 5 0 8 0 0 0 0
0 0 7 0 0 3 0 0 0 0
0 0 0 0 0 0 0 0 0 0
3 0 0 3 0 0 0 0 0 0
0 0 7 0 0 0 0 0 3 0
0 0 0 0 2 0 0 0 0 0
0 0 0 0 0 0 0 0 0 4
0 0 0 7 0 0 3 0 4 9
0 7 0 0 0 0 0 0 9 9