8 8 4 34
0 0 0 0 0 0 4 4
0 3 3 3 3 0 0 0
3 3 0 0 1 3 3 0
1 1 3 3 3 1 1 3
3 3 1 2 2 3 1 1
4 4 0 1 0 0 3 3
4 0 2 1 0 0 0 0
0 0 2 1 0 0 4 4
6 0 0 0 0 0 5 0
0 2 0 2 0 0 0 0
2 0 0 0 0 0 0 0
0 0 1 1 0 0 0 1
0 0 0 0 0 2 0 0
0 0 3 0 0 6 2 0
7 0 0 1 0 0 0 0
0 0 0 4 0 0 0 0