10 6 3 13
4 2 2 2 0 0 4 3 3 3
4 0 0 0 1 0 0 0 4 4
1 1 1 1 1 1 1 1 0 1
1 1 1 0 0 1 1 1 1 1
0 0 5 5 5 0 0 1 1 1
4 4 0 0 0 0 5 5 4 4
0 0 0 0 0 0 0 4 0 8
0 0 0 0 1 0 2 0 0 0
1 0 0 0 0 0 0 0 0 0
0 0 0 0 0 0 0 0 0 0
0 0 0 1 0 0 0 0 0 0
9 1 0 0 0 0 9 0 0 0