8 8 2 16
3 3 3 3 3 3 3 0
3 1 4 0 0 4 4 4
2 2 1 1 0 0 4 0
3 4 2 1 4 4 4 4
0 4 2 1 1 0 1 1
0 0 2 2 1 1 1 3
4 4 1 1 1 3 3 3
0 0 1 3 3 3 3 3
0 0 0 3 4 0 0 0
0 0 0 2 0 0 0 0
0 0 0 0 0 0 0 0
1 0 0 0 0 4 0 0
0 0 0 0 0 1 0 0
6 0 2 0 0 0 0 0
6 0 0 0 0 0 0 0
0 0 5 0 0 0 0 0